Abal - paleness
Aban - construct
Abod - strike
Abol - juggler
Abras - seer
Absam - search
Abshoth - scourge
Acöb - egg
Ad - sun
Adbok - sponge
Adek - side
Adil - wall
Adril - weaver
Adur - soil
Ag - daub
Agsal - pool
Agseth - ache
Agêk - bee
Akam - fortune, luck
Akath - winter
Akest - domination
Akgos - clinch
Akir - reward
Akith - wrath
Akmesh - tempest
Aknûn - hawk
Akrul - tin
Al - pinnacle
Alak - ace
Alek - humor
Alen - moth
Alis - kiss
Allas - sea
Almôsh - gleam
Alnis - war
Alod - day
Alron - amethyst
Alud - brother
Alåth - bolt
Alûth - defect
Amal - teacher
Amas - depth
Amem - curl
Amith - delight
Amkin - gladness
Amkol - councellor
Ammesh - silt
Amnek - tribute
Amost - town
Amud - thunder
Amug - fog
Amur - dirt
An - meditation
Anam - age
Anan - night
Aned - sport
Ang - redness
Angish - scum
Angrir - crusher
Angzak - terror
Anil - glory
Anir - sister
Anist - ignition
Anriz - sky
Anur - wonder
Anzish - alchemy
Anön - onion
Ar - flesh
Arak - shaft
Aral - woman
Aran - sculpture
Arban - cradle
Arbost - deification
Arceth - strategy
Ardes - author
Arek - church
Arel - water
Arist - assault
Arkim - race, group, dwarf
Arkoth - prophecy
Arngish - entrails
Aroth - magic
Aroz - savagery
Arros - thrower
Artob - combination
Artum - worshipper
Arust - bowl
Arzes - knight
Ashmôn - shade
Asdobb - not, none, no, zero
Ashok - time
Ashzos - distraction, annoyance
Asin - lunch
Asiz - flash
Ashak - scorpion
Asmel - merchant
Asob - board
Asol - seizure
Asrer - appearance
Assar - circumstance
Assog - disloyalty
Ast - sabre
Astan - fleck
Astel - ally
Astesh - cudgel
Astis - dune
Astod - gulf, distance
Astås - rogue
Asàs - rapidity
Asën - gravel
Atem - rat
Atham - focus
Athel - ring
Athnîr - mastery
Athser - charcoal
Atil - whiskey
Atith - straw
Atol - truth
Ator - perfection
Atul - ford
Atzul - glade
Atêsh - radiance
Atír - dye
Atîs - stake
Atöl - finder
Aval - love
Avan - lyric
Avum - culmination
Avuz - mine, to mine
Avûsh - infection
Azin - watch
Azmol - obscurity
Azoth - immortality
Aztong - stench
Bab - pet
Babin - friend
Bakat - game
Bakust - urge
Bal - tone
Balad - coil
Bamgûs - weasel
Banik - hex
Bardum - fight
Baros - funeral
Bashnom - barbarity
Batôk - problem
Bebmal - glen
Becor - temptation
Bekar - dip
Bekom - spring, season
Bel - grayness
Belal - fame
Belar - salute
Belbez - goat
Bem - flute
Bemòng - apple
Ber - earth
Berath - cream
Berdan - walk
Berim - artifice
Besmar - pulley
Betan - calm
Biban - ball
Bidok - act
Bim - sling
Birir - diversion, detour(n.)
Birut - string
Bisek - veil
Bisól - peace
Bithsêst - triangle
Bobet - trifle
Bobrur - mother
Bocash - ruthlessness
Bogsosh - brigand
Bokbon - heather
Bol - grower
Bom - home
Bomik - vermin
Bomrek - whip
Bonun - soot
Bor - chunk, Mom (shortened form of mother)
Borbor - maternal grandmother
Borborbor - maternal great-grandmother
Borik - trench
Borlon - severity
Boshut - alliance
Bot - tile
Bothon - murk
Budam - yearling
Bufut - tusk
Bugsud - blister
Bugud - tummy
Bukith - turmoil
Bukshon - jaundice
Bukèt - quickness
Bul - lard
Bumal - worry
Bungek - lizard
Buris - tub
Bushos - spawn
Buzat - twig
Bàgoz - slime
Bâsen - spray
Bål - growth
Bëmbul - mechanism
Bërûl - bastion
Cabnul - fool
Catten - channel
Cemosh - mischief
Cenäth - adventure
Cerol - lens
Ceshfot - puppet
Cilob - roof
Cim - juice
Cog - boot
Comníth - butterfly
Conngim - suitor
Cubor - worker
Cuggán - sand
Custith - passage
Cös - cake
Dakas - color
Dakon - omen
Dakost - floor
Dal - greed
Dalem - incident
Dalzat - match, contest
Damol - pitch
Damor - twine
Damèl - loyalty
Damîd - witch
Dan - couple
Danman - heaviness
Daros - moss
Darål - clock
Darùd - climate
Dasnast - steppe
Dastot - sword
Dasël - heaven
Datan - iron
Datlad - treat
Datur - spire
Deb - eater, to eat
Debish - spasm
Dedros - gore
Deduk - manor
Deg - way
Degël - galley
Deler - steel
Deleth - polish
Desgir - desire
Desis - snarl
Detes - ram
Detgash - vulgarity
Detthost - leper
Dimshas - poetry
Disuth - nightmare
Dizesh - trim
Dodók - clasp
Dogik - wad
Dok - hegemon
Dolek - comet
Dolil - lock (hair)
Dolok - obstacle
Domas - guild
Doren - diamond
Doshet - shingle
Dostob - clearing
Dostust - torment
Dosîm - wisdom
Dotir - fever
Dozeb - fruit
Ducim - work
Dudgoth - bog
Dugal - parity
Dugan - shovel
Dum - mouth
Dumat - roughness
Dumed - fortification
Dumur - haunt
Dur - fist
Durad - beard
Dural - honor
Dusak - mite
Dushig - gall
Dustîk - steed
Duthal - worth
Duthnur - guard
Duthtish - inferno
Duz - smear
Dák - tree
Dáthnes - pad
Dèg - evenness
Dëm - date (fruit)
Dënush - casket
Dîbesh - craziness
Dîshmab - rampart
Dôbar - creation
Dùstik - boar
Eb - sucker
Ebal - reverence
Ebgok - jack
Ebsas - candy
Ecem - tube
Eddaz - midnight
Edim - ray
Edir - dungeon
Edod - boredome
Edos - amazement
Edtûl - groove
Edzul - vestibule
Edëm - key
Edól - weathering
Egath - jungle
Egdoth - bow
Egeb - bulb
Egen - gift
Eges - persuasion
Egeth - misery
Eggut - gully
Egom - nature
Egot - chip
Egståk - eviscerator
Egul - control
Egur - sorrow
Ekast - safety
Ekir - lucidity
Eknar - ugliness
Ekur - might
Elbel - renown
Elbost - pumpkin
Elcur - plague
Ellest - kin
Emal - sense
Emen - strength
Emgash - rider
Emtan - keg
Emuth - beak
Emär - animal
Emäth - band (object)
Enam - purity
Enas - doctrine
Endok - attic
Enen - illness
Engig - flax
Enir - beguiler
Enkos - taker
Ennol - reputation
Enog - frog
Enol - grizzle
Enseb - basis
Enshal - bud
Enten - distraction, game
Enur - hug
Enôr - blueness
Er - fat
Eral - vessel
Erar - leader
Eren - liberty
Gorge - erib
Erith - throat
Ermis - aunt
Erok - plant
Erong - bile
Ertal - luxury
Erush - handle
Esar - quiescence
Eser - glitter
Eshim - freedom
Eshom - silence
Eshon - good
Eshtân - smith
Esrel - queen
Estrith - spy
Eststek - flea
Esäst - evaporation
Etar - king
Etest - duty
Ethad - decency
Ethram - ripeness
Ethír - yarn
Etnàr - cooperation
Etom - sacrifice
Etost - container
Etur - boulder
Etvuth - scandal
Etóm - innocence
Evon - lover
Evost - sect
Evud - monk
Ezar - soldier
Ezost - malice
Ezuk - raunch
Fak - drain
Famthut - horse
Farash - creed
Fashuk - meanness (nastiness)
Fastam - jailer
Fath - sack
Fathkal - meal, food
Fazís - celebration
Feb - arrow
Fel - seam
Fenglel - fly
Fer - beast
Fesh - wing
Fevil - mongrel
Fidgam - assembly
Figul - gland
Fikod - glaze
Fikuk - field
Fimshel - persuader
Fokásh - hunger
Fongbez - pungency
Fotthor - forest
Fullut - rabble
Furgig - pulp
Furàt - virginity
Gadan - honesty
Gakit - thief
Gamil - trust
Gan - dish
Gar - destroyer
Gashcoz - proliferation
Gasir - scrap
Gasol - breath
Gast - cleft
Gasìs - satin
Gatin - panther
Gatis - muffin
Geb - dent
Gecast - skewer
Gedor - evil
Geles - snack
Gelut - threat
Gembish - seal (animal)
Gemesh - conflict
Gemsit - pastime
Gemur - prestige
Genlath - seduction
Geshak - bait
Geshud - fortress
Gesis - sinew
Geth - past, Past-tense marker
Gethor - dirge
Gethust - harshness
Gidur - memory
Gidin - flier
Giken - lightning
Gikut - dabbler
Gim - twist
Ginet - crew
Gingik - chestnut
Gingim - distrust
Ginok - peach
Gintar - girdle
Gireth - image
Girtol - business
Gishgil - contempt
Gisëk - cobra
Givel - scuffle
Goden - rope
Godum - mucus
Golud - harvest
Gomath - legend
Gomòk - mole
Gomóm - dourness
Gonggash - flayer
Gongith - squid
Gor - pit
Goral - garlic
Gorroth - disemboweler
Goshîst - impurity
Gothum - bottom
Govos - leaf
Gudas - scoop
Gulgun - froth
Gulnas - island
Gumùr - idleness
Gusgash - stoker
Gusil - copper
Guthstak - spurt
Gutid - utterance
Guz - simplicity
Gärem - general
Gäzot - sloth
Gérig - bank
Gídthur - grasp
Gósmer - umbra
Götom - cavity
Gúr - bowel, gut
Ib - pebble
Ibel - zenith
Ibes - sugar
Ibruk - ash
Id - rock
Idar - dog
Idash - moistness
Idek - brain
Iden - paddle
Idgag - subordinate
Idith - system
Idor - howl
Idos - call
Idräth - treasure
Ifin - hardiness
Igang - goo
Igath - scrape
Igest - gloss
Igril - meat
Igër - river
Ikal - healer
Iklist - whisper
Ikud - reign
Ikus - hopper
Ikûl - nest
Il - word
Ilash - league
Ilbåd - guile
Ilid - ruler
Ilir - joy
Ilon - healing
Ilral - treaty
Ilrom - peak
Ilush - carnage
Imbit - hovel
Imketh - justice
Immast - influence
Imsal - race (contest)
Imush - dike
Imust - mange
Inash - organ
Inem - requirement
Inen - hill
Ineth - city
Ingish - bodice
Ingtak - twilight
Ingul - season
Inir - decline
Innok - creepiness
Inob - meal (ground)
Inod - gate
Inol - yellowness
Inrus - poison
Insél - gang
Inush - righteousness
Irid - rhythm
Isden - watchfulness
Iseth - quest, job, task
Ish - bar
Ishash - cusp
Ishen - passion
Ishlum - nut
Ishol - frigidity
Isin - grass
Ison - plan
Isos - dale
Istam - light
Istbar - rose
Istrath - jewel
Isul - faith (religion)
Ital - neutrality
Itnet - uncertainty
Ittás - tenderness
Itur - lute
Itêg - tentacle
Ivom - farm
Izeg - ape
Izkil - intricacy
Kab - name
Kabat - thrift
Kacoth - confinement
Kadol - hatchet
Kadôl - gem
Kafâsh - sick
Kagmel - plum
Kal - smile
Kalur - throne
Kamuk - priest
Kamut - ripper
Kan - tiredness
Kanzud - convent
Kar - dimension
Karas - compassion
Kasben - tuft
Kashez - lesson
Kasith - prowler
Kast - genius
Kastar - block
Kastaz - conjunction
Kastol - emancipation
Kat - goal
Katthir - nourishment
Kavud - mush
Kebon - odor
Kebul - sparkle
Kebösh - zealot
Ked - feed
Kegeth - hold
Kekath - tundra
Kel - metal
Kemsor - entrance
Ken - whim
Keng - steam
Kenis - meadow
Ker - eye
Kerlîg - shell
Kes - scratch
Kesh - tail
Kesham - curiosity
Keshan - flame
Kesting - meteor
Kethil - principle
Kez - negator
Kezar - rust
Kezat - danger
Kezkíg - connection
Kib - net
Kidet - talon
Kifed - crux
Kigok - spring (device)
Kik - speck
Kikrost - stockade
Kil - wheat
Kilrud - bronze
Kin - oak
Kinem - beauty
Kiron - holiness
Kiror - cell
Kirun - mushroom
Kisat - emptiness
Kisul - hop
Kithìn - cactus
Kitïg - business
Kivish - lancer
Kizbiz - deer
Kizest - zeal
Kob - spoon
Kobel - summit
Kobem - trouble
Kod - blot
Kodor - dawn
Kogan - boat
Kogsak - palisade
Kokeb - dweller
Kol - wheel
Kolad - ghoul
Komut - poem
Konad - band, group
Konos - brass
Kontuth - cinnamon
Kor - cavern
Kordam - cosmos
Korsid - festival
Kosak - drinker
Kosh - slaughter
Koshmot - weed
Koshosh - library
Kosoth - palace
Kot - start
Kovath - bushel
Kovest - pearl
Kozoth - horror
Kudar - immortal
Kudust - prince
Kugik - plate
Kukon - recreation
Kulbet - adulation
Kulet - abbey
Kulin - palm
Kumil - armory
Kun - cat
Kurel - lion
Kurig - goose
Kurik - thorn
Kurol - embrace
Kussad - waviness
Kutam - speaker, First person (pseudo-pronoun)
Kuthdêng - accident
Kàlreth - humidity
Kès - quietness
Kâkdal - brim
Kälán - trail
Kåtdir - glimmer
Kåtâk - scale
Kèbmak - garnish
Kêdnath - naughtiness
Kìrar - right
Kôkdath - unholiness
Kôn - master
Kûbuk - lance
Lakish - back
Lakàl - winnower
Laltur - cover
Lam - stone
Langgud - shin
Lanlar - bird
Lanzil - veneration
Lar - meeting
Lased - insect
Lashid - spittle
Lashëd - prophet
Lathon - myth
Lebes - apex
Led - rack
Legon - wanderer
Lek - bristle
Lektad - lure
Lelum - wane
Lemis - vine
Lemlor - fanciness
Lenod - seed
Lensham - den
Lerteth - tangle
Lestus - rabbit
Letmos - cobalt
Letom - convenience
Libad - praise
Libash - axe
Lidod - waste
Likot - ink
Lim - wisp
Limul - gold
Limâr - wealth
Limúr - nadir
Linòn - continent
Lir - climax
Liruk - violence
Lirér - slop
Lisat - notch
Lised - mark
Lish - wickedness
Lisid - clash
Lisig - berry
List - gaze
Litast - torch
Litez - sorcerer
Lod - one
Lodel - date (activity)
Logem - paint
Lokast - butcher
Lokum - spear
Lolok - granite
Lolor - letter
Lolum - wood
Lorbam - standard
Lorsïth - eagle
Losush - olive
Lotol - order (group)
Lulâr - rooter
Lumash - frenzy
Lumen - jester
Lumnum - labyrinth
Lun - cloud
Lunrud - diminishment
Lur - hate
Lurak - canker
Luror - cruelty
Lushòb - lowness
Lushôn - end
Lushût - guilt
Luskal - indignation
Luslem - puzzle
Lândar - affection
Lâven - prairie
Lål - blanket
Låluth - flood
Lårul - magician
Lêgan - mirth
Lêned - shelter
Lêrush - wretch
Lîlar - pattern
Lînem - face
Lïd - tightness
Lòr - tool
Lòråm - cathedral
Lûk - insight
Lûrit - spine
Mabdug - ale
Madush - pear
Mafol - chamber
Mamot - plait
Manthul - deviance
Mas - grain
Mashus - grape
Maskir - equivalence
Mat - bend
Maton - joke
Matul - dance
Meb - inch
Meban - stream
Mebzuth - oar
Med - abatement
Meden - tribe
Medtob - blockade
Megob - pus
Melbil - tome
Memad - rein
Memrut - crucifixion
Meng - lash
Mengib - ulcer
Mengmad - lip
Mer - uncle
Merig - clarity
Merir - pregnancy
Merseth - luck
Mes - creature
Mesir - shower
Messog - tumor
Mestthos - citadel
Metul - cross
Mezum - smoke
Midil - morsel
Midor - power
Migrur - ocean
Milol - messiah
Minbaz - enchantment
Mingkil - leopard
Mingtuth - contingency
Mingus - maggot
Minkot - corridor
Minran - ditch
Miroth - denomination
Mirstal - velvet
Mis - haze
Mishar - deity
Mishthem - scholar
Misttar - knowledge
Mistêm - portal
Mithmis - gristle
Mogshum - elbow
Mokez - cage
Moldath - avalanche
Momuz - crypt
Mondûl - grave
Monom - paper
Mor - temple, head
Moshnún - suicide
Mosos - tragedy
Mostib - orange
Mostod - shame
Mosus - room
Mot - strangeness
Mothdast - onslaught
Mothram - curse
Mozib - swallow
Mubun - practice
Mugshith - torture
Mukar - sadness
Mulåsh - confederacy
Munsog - vileness
Munèst - grove
Murak - boldness
Musar - knower
Musöd - chastity
Muthir - column
Muved - ooze
Muz - fungus
Muzish - martyr
Mâtzang - jump
Måmgoz - dragon
Mëlist - tournament
Mìshos - beach
Mîvid - shriek
Mïkstal - ownership
Mïshak - speechlessness
Mörul - page
Mözir - rout
Mûthkat - mansion
Nabid - salt
Nabreth - skirt
Nabår - wish
Nadak - defender
Nakas - enjoyment
Nakuth - braid
Nal - hour
Nalish - forever
Nalthish - menace
Nam - destiny
Namàsh - brew
Nangês - bean
Nanir - rhyme
Nanul - scab
Nar - oblivion
Nashon - bloodiness
Nasod - snail
Nazush - blood
Nebél - admirer
Nebïn - lamb
Necak - neutralization
Ned - flank
Nekik - coldness
Nekol - skull
Nekut - secret
Nel - baker
Ner - lake
Neshast - risk
Nesteth - silk
Neth - balance
Nethgön - lust
Nicat - chain
Nidòst - ferocity
Nikot - action
Nikuz - pride
Nil - hammer
Nilgin - prank
Nimak - quill
Nimar - path
Nin - toe
Ninur - escort
Niral - portent
Nirkún - trial
Nirmek - defense
Nis - supper
Nisgak - frost
Nish - trade
Nist - fear
Nisûn - warning
Nitem - vision
Nitig - bite
Nitom - planet
Nizdast - ignorance
Nobgost - tick (animal)
Noböt - spurn
Nod - toad
Nog - foot
Noglesh - savage
Nokgol - riddle
Nokzam - battle
Nol - tongue
Nolthag - cyst
Nolêth - gulf (sea)
Nomal - staff
Nomes - diversion (game)
Noram - relief
Noshtath - devourer
Nosing - brush
Nosîm - kindness
Noth - slave
Nothis - grief
Nothok - obeisance
Notlith - ruin
Noval - bride
Nozush - vegetation
Nucam - consideration
Nug - cad
Nuggad - donkey
Nuglush - gutter
Nugreth - weather
Nukad - victim
Nulom - blame
Nulral - stability
Num - wind
Nunok - number
Nunùr - crevice
Nural - blindness
Nurom - desk
Náshas - lilac
När - rawness
Nåst - show
Nåzom - dream
Nëlas - flicker
Nîles - strap
Nïng - burn
Nïr - land
Nòm - god
Nóton - birth
Nônub - punch
Nökor - dead
Ngalák - abyss
Ngathsesh - puke
Ngegdol - depression (low)
Ngilok - evisceration
Ngithol - immorality
Ngitkar - fisher
Ngobol - glumness
Ngotol - ghost
Ngotûn - cult
Ngumrash - sickness
Ngárak - beetle
Ob - tar
Obash - swine
Obok - pillar
Obot - crack
Obur - hero
Ocîg - dell
Od - limb
Oddom - cloister
Odgúb - mob
Odkish - fern
Odom - basin
Odshith - clam
Odur - root
Odês - monger
Og - club
Oggez - hole
Ogon - drawl
Ograd - reason
Ogtum - morass
Ogîk - camp
Okab - breaker
Okag - bloat
Okang - yore
Okbod - doom
Okil - test
Okin - equity
Okir - elder
Oklit - village
Okol - voice
Okon - burden
Okosh - vigor
Okun - shrine
Ol - mud
Olil - valley
Olin - tongs
Olmul - bath
Olnen - poet
Olom - brunch
Olon - gear
Olthez - sorcery
Oltud - stalker
Olum - dispersal
Om - clutter
Omer - greenness
Omet - fluke
Omoth - laziness
Omrist - wildness
Omshit - suffering
Omtug - wart
Omtäl - liberation
Omât - spice
Onam - larva
Onesh - confederation
Onget - turquoise
Onlìl - breakfast
Onol - mountain
Onrel - exit
Onshen - chant
Orab - leak
Oram - world
Orrun - roar
Orshar - web
Orshet - cremation
Orstist - reclusion
Os - lie
Osal - song
Osdin - rip
Osed - bin
Oshgât - shack
Oshnïl - betrayal
Oshosh - hermit
Oshot - vanishment
Oshur - circle
Oshéb - trough
Osod - bone
Osor - kingdom
Osram - fortune (wealth)
Osresh - mortification
Ost - fold
Ostar - burial
Ostath - esteem
Ostësh - mess
Otad - hand
Otam - nose
Otel - hay
Oth - knot
Othduk - moment
Othil - weakness
Othsal - sewer
Othud - morality
Othôs - wilt
Othör - erasure
Otik - sheen
Otil - jade
Otin - wine
Otsus - ankle
Ottan - mind
Ottem - sanctum
Otung - shock
Ovus - mold
Ozleb - disappearance
Ozon - depression (sadness)
Ozor - subtlety
Ozsit - crab
Rab - glow
Rabed - freckle
Rafar - cook
Rafum - coincidence
Rakas - stranger
Rakust - tomb
Ral - silver
Ralâth - lamentation
Ramtak - execution
Rangab - chocolate
Ranzar - coalition
Rashgur - attack
Rasuk - sliver
Rath - temple (building)
Raz - tooth
Razes - hair
Razmer - violator
Razot - raptor
Reg - glove
Reked - butter
Reksas - sin
Rerik - leprosy
Rerras - fissure
Resíl - comedy
Rethal - society
Rigòth - craft
Rikkir - whisker
Rilbet - market
Rilem - youth
Rimad - tactic
Rimtar - castle
Rimís - lesion
Rinal - ivy
Rinmol - marsh
Rintor - bug
Rinul - intensity
Rir - ear
Riril - fellowship
Rirnöl - respect
Ritan - beginning
Ritas - owl
Rith - bell
Rithlut - wax
Rithul - petal
Rithzâm - bulwark
Robek - barb
Rodem - pelt
Roder - baldness
Rodnul - domicile
Roduk - ferry
Rodum - bowel, interior
Rokel - scenario
Roldeth - anguish
Romek - length
Romlam - cloak
Ron - rage
Rorash - calamity
Rorul - bush
Rorung - hound
Ros - decision
Chapel - rosat
Rotik - nettle
Rovod - arch
Rovol - sanctuary
Rozsed - buckle
Ruken - communion
Rulush - splash
Rumred - pepper
Rungak - skunk
Rurast - guise, form, shape
Rusest - pimple
Ruthösh - distance
Ruzos - extrication
Râluk - hail
Râmol - euphoria
Räduk - bitterness
Räm - prison
Råsh - death
Rèt - pocket
Rêg - stray
Rëcus - thirst
Rëdreg - trash
Rëmrit - dreg
Rërith - chaos
Rìthar - trammel
Ríbar - homage
Rít - cut
Rîsen - coal
Rîthol - noble
Róth - domain
Rômab - lime
Rùkal - eeriness
Rúbal - gill
Sacat - dot
Sakil - slit
Sakub - dumpling
Salir - adoration
Salul - skin
Samam - courage
Saneb - sleeve
Sanreb - owner
Sanád - morning
Saruth - girl
Sarvesh - furnace
Saràm - greatness
Sastres - princess
Sat - stroke
Savot - stance
Sazir - bridge
Sebshos - mire
Sebsúr - vale
Sebïr - hide
Sedil - angel
Sedish - infamy
Sedur - emerald
Sefol - entry
Selor - rite
Semor - union
Ser - head
Sesh - socket
Seth - falsehood
Sethal - spider
Setnek - buzzard
Sibrek - salve
Sidos - button
Sigun - tour
Sikel - hood
Siknug - dwelling
Sil - plane
Sined - sweat
Sinsot - claw
Sirab - warmth
Sitheb - grub
Siz - grease
Sizir - vice
Sobìr - release
Sodel - shield
Sog - conqueror
Sogdol - famine
Sokan - phrase
Solam - nation
Solon - flag
Soloz - worship
Som - oracle
Sombith - executioner
Sosad - ivory
Sosh - sandal
Soshosh - jackal
Sosmil - louse
Sostet - weevil
Sub - drip
Subol - leech
Sudir - cinder
Sulus - crater
Sumun - griffon
Suthmam - breeches
Suton - gut
Sutung - malador
Suvas - luster
Sákrith - blaze
Sárek - echo
Såkzul - trumpet
Sêgam - vegetable
Sîbosh - deterioration
Sïsal - gallows
Sôd - mist
Sûbil - robustness
Shadkik - creep
Shadmal - confusion
Shadust - bunion
Shagog - stasis
Shagul - minion
Shalig - bridle
Shan - family
Shar - mile
Sharast - epidemic
Sharsid - blight
Sharul - impunity
Shasad - music
Shasar - fright
Shash - hell
Shatag - cluster
Shazak - symmetry
Sheced - carnality
Shed - order (concept)
Shedim - shadow
Sheget - horn
Shegum - drool
Shelret - trance
Shem - plank
Shesam - zephyr
Sheshek - tip
Shetbêth - twinkle
Shethel - serpent
Shigin - autonomy
Shigós - pack
Shilràr - tulip
Shin - brightness
Shis - fang
Shithath - perishment
Shizek - contingent
Shoduk - dive
Shokmug - cheese
Sholid - clutch
Sholil - stick
Sholèb - gallery
Shomad - bottle
Shorast - wire
Shoshin - wrack
Shosêl - fragrance
Shotom - tornado
Shoveth - mystery
Shuk - droopiness
Shulmik - seducer
Shungmag - disgust
Shusug - corruption
Shèrel - bunny
Shìstsak - starvation
Shùrrat - stump
Sogg - to see
Stagshil - fin
Stal - buster
Stalkòb - boil
Stanïr - wreath
Stegëth - organization
Stektob - blotch
Stemel - responsibility
Stettad - tax
Stetár - honey
Stibmer - shore
Stidest - dress (clothing)
Stigaz - rasp
Stin - strife
Stingbol - barbarian
Stinthäd - theater
Stistmig - entanglement
Stisträs - pla, performance
Stizash - kindling
Stodir - volcano
Stoling - mouse
Ston - fealty
Storlut - dimple
Stosêth - newt
Stot - surprise
Stukos - razor
Stul - maw
Stâkud - machine
Stëlmith - tress
Stëtnin - inn
Stîgil - jaw
Tabar - faith (loyalty)
Tabmik - itch
Tad - match (equal)
Tadar - mortality
Tagùz - leap
Takùth - chasm
Talin - drum
Talul - language
Tan - tick (clock)
Tangak - spot
Tarag - hog
Taran - shark
Tarem - fate
Tarmid - blade
Taron - yell
Tastrod - distinction
Tat - touch
Tath - dusk
Tathtak - wasp
Tathur - scribe
Tatlosh - fish
Tazuk - hut
Tecàk - sweetness
Tegir - breed
Tekkud - pick
Teling - coast
Tenshed - chance
Terstum - destruction
Teshkad - price
Teskom - jail
Tesum - controller
Tetist - flimsiness
Tetthush - pantomime
Tezad - pot
Tezul - noose
Tig - dung
Tikis - vulture
Tiklom - frame
Tilat - child
Tilesh - truss
Timad - stunt
Tinan - sneer
Tinöth - equality
Tirist - rim
Tishak - typhoon
Tishis - spiral
Tislam - dessert
Tithleth - rumor
Titthal - play (fun)
Tizöt - shank
Tobot - authority
Tobul - canyon
Todör - elevation
Togal - storm
Tok - planter
Tokthat - scorn
Tolis - top
Toltot - raven
Tomus - shove
Tomêm - group
Torad - body
Toral - law
Torir - void
Torish - crown
Tosid - armor
Tost - vise
Totmon - flower
Tozör - slug
Tudrug - vandal
Tulon - road
Tumam - moral
Tun - door
Tunom - mortal
Tunur - style
Turel - learning
Tustem - courtesy
Tâmol - savior
Tårem - thimble
Tílgil - candle
Tízen - trickery
Tîrdug - brute
Tòm - belly
Tôsed - stop
Tögum - verse
Tölún - saint
Tömud - apogee
Thabost - flare
Thabum - gulf, pit
Thad - crowd
Thak - lock (device)
Thalal - empire
Tharith - hurricane
Tharnas - slayer
Thasdoth - exaltation
Thash - mead
Thatthil - autumn
Thazor - discovery
Thebil - silkiness
Thedak - clan
Therleth - snake
Thestkig - conflagration
Thet - peek
Thetdel - hare
Thethrus - periwinkle
Thetust - purge
Thikén - confidence
Thilség - tarnish
Thimshur - partner
Thining - sap
Thir - harmony
Thistus - loaf
Thob - girder
Thocit - spike
Thokdeg - obscenity
Thokit - affliction
Thol - deep
Tholest - cyclone
Tholtig - barricade
Thomal - charity
Thortith - spell
Thos - bunch
Thosbut - drill
Thoth - aura
Thukkan - amber
Thulom - monastery
Thum - muscle
Thun - Dominion
Thunen - life
Thur - universe
Thusest - fury
Thuveg - pig
Thêmnol - inconvenience
Thîdas - frill
Thîkut - book
Ubal - spirit
Ubas - scream
Ubbul - vault
Uben - soap
Ubur - glutton
Ucat - beer
Ud - will
Udar - rain
Udib - syrup
Udil - lantern
Udir - blackness
Udist - pleat
Udiz - present
Udler - mule
Udos - man
Udril - ox
Ugath - belch
Ugeth - phlegm
Ugog - bane
Ugosh - hollow
Ukath - sludge
Uker - wave
Ukosh - dearth
Ul - pants
Ular - idol
Uleb - lemon
Uling - craze
Ullung - conjurer
Ulthush - hag
Um - nail
Umar - smoothness
Umer - blush
Umgan - ambiguity
Umgush - weird
Umid - fall
Umom - darkness
Umoz - rampage
Umril - pine
Ungèg - failure
Unib - rag
Unkíl - thrall
Unnos - hoof
Unol - soul
Unos - wail
Unul - dankness
Ur - hearth
Urdim - tower
Urem - father
Urir - marble
Urist - dagger
Urnût - servant
Urosh - wraith
Urrïth - scar
Ursas - decay
Urus - fell
Urvad - seal (art)
Usen - help
Ushal - treason
Ushang - monster
Ushat - basement
Ushdish - saffron
Ushesh - imprisonment
Ushil - ice
Ushlub - mop
Ushul - realm
Usib - oat
Usir - glacier
Ustir - crow
Ustos - anger
Ustuth - fence
Usur - spoils
Usân - murder
Utheg - cancer
Uthgúr - demon
Utir - loot
Uvar - lull
Uvash - arena
Uvel - bear
Uvir - putrescence
Uvóth - shred
Uzan - allegiance
Uzar - grotto
Uzlir - faction
Uzol - oil
Vabôk - orb
Vafig - trick
Vagúsh - killer
Vakist - lace
Vakun - deceiver
Vanel - visionary
Vankåb - monkey
Var - To be
Vashzud - disembowelment
Vath - hatred
Vathem - saturninity
Vathez - virgin
Vathsith - square
Vel - line
Ver - to become, Passive voice marker
Vesh - dust
Vesrul - worm
Vetek - target
Vildang - profanity
Vim - tear
Vir - humility
Vod - sound
Volal - whiteness
Vozbel - ravager
Vucar - urn
Vudnis - tenacity
Vukcas - crescent
Vuknud - strangulation
Vukrig - rift
Vumom - savant
Vumshar - gloom
Vunom - lung
Vuthil - flight
Vutok - figure
Vutram - gale
Vîr - star
Vúsh - heat
Zafal - air
Zag - dress (general)
Zagith - devil
Zagstok - muck
Zakgol - spite
Zaled - noiselessness
Zalstom - medicine
Zalud - future
Zalìs - ward
Zamnuth - excavation
Zamoth - venom
Zan - artifact
Zaneg - relic
Zangin - creek
Zanor - heart
Zanos - hope
Zar - outrage
Zareth - desert
Zarut - insanity
Zas - crystal
Zasgim - toast
Zasit - knife
Zatam - clout
Zatthud - judge
Zedot - lobster
Zefon - fountain
Zeg - tattoo
Zekrim - snot
Zengod - dignity
Zenon - viper
Zes - brand
Zethruk - enchanter
Zikel - fierceness
Zikâth - filth
Zilir - imperative (tense marker)
Zim - crest
Zimesh - phantom
Zimkel - plain
Zimun - callus
Ziril - fire
Zithis - mesh
Zocol - coven
-zod(en) - house (suffix)
Zoden - house
Zodost - rot
Zokgen - rancor
Zokun - siege
Zolak - blizzard
Zoluth - combat
Zon - helm
Zotir - fiend
Zuden - keeper
Zuglar - ship
Zukthist - quandary
Zulash - pain
Zulban - banner
Zunek - sourness
Zuntîr - anvil
Zursul - sever
Zust - bed
Zustash - ancient
Zutshosh - bewilderment
Zutthan - treasury
Zágod - grip
Zägel - closet
Zêvut - dread
Zìzcun - reticence
Âbir - romance, to romance
Âgez - to pad
Âgoth - competition, to compete
Âl - weight
Âm - speech, to speak
Âmid - to listen
Ân - clod
Âst - fur
Âtast - bravery, to brave
Âtrid - blossom, to blossom
Âzkob - incense
Ádol - complexity
Ágesh - contest, to contest
Àlil - glee
Äbor - to knit
Ägash - bandit
Äkig - to stretch
Äkil - point
Äkim - brilliance
Ärged - boy, son
Äs - cave
Êlbem - to sway
Êsik - trooper
Élmeth - to cling
Éth - to shut
Éthes - to glisten
Étol - pass
Ézneth - fragment, to fragment
Èfim - hedge
Èrith - labor, to labor
Èrnam - modesty
Èshgor - eel
Èzum - hame
Ëlot - buck
Ërtong - gerbil
Ëtul - to fling
Îbmat - spark
Îcum - virtue
Îd - year
Îgam - to gorge
Îgbit - cottage
Îkeng - cotton
Îlkeb - to slosh
Îm - plot, to plot
Îmäz - belt
Îslig - critter
Îtat - chill, to chill
Îton - hall
Íkthag - to squeeze
Ím - bread
Ìddor - lark
Ìltang - fork, to fork
Ìlud - admiration
Ìnal - to lull, to mislead
Ìrlom - permanency
Ìtdùn - charm, to charm
Ïdath - amusement, to amuse
Ïggal - trap, to trap
Ïkor - warrior
Ïlon - moon
Ïlun - to hail, to greet
Ïlul - lord
Ïngiz - ceiling
Ïsir - to fray
Ïteb - post
Ïthod - to scrub
Ïtsas - poker, to poke
Ôfid - cup
Ôggon - vomit
Ôler - to dwindle
Ôm - to crush
Ônam - to shimmer
Ônor - despair
Ôsed - maze
Ôsust - to tame
Ôtthat - direction, order, command, to direct, to order, to command
Óboth - droplet
Ód - tunnel, to tunnel
Ódad - feast, to feast, to celebrate
Ók - finger
Ór - drink, to drink
Óruk - habit
Ós - certainty
Ònul - mirror, to mirror
Òrdir - incineration, to incinerate
Òstob - spit
Ögred - swamp
Öndin - to fade
Öntak - arm
Össek - council
Ûbom - meanness (lowness)
Ûd - harvester, to harvest
Ûlmush - deference
Ûlosh - stigma
Ûthir - to sear
Ûz - growl, to growl
Útost - aquamarine
Ùk - dinner
Ùnil - hammerer
Ùshrir - quake
Ùst - breach, to breach
Åblel - bust
Åkum - catch, to catch
Åm - baby, yawn, to yawn
Åmmeb - dump, to dump
Åmât - hip